{
  "安徽": "安徽",
  "北京": "北京",
  "福建": "福建",
  "甘肃": "甘肅",
  "广东": "廣東",
  "广西": "廣西",
  "贵州": "貴州",
  "海南": "海南",
  "河北": "河北",
  "河南": "河南",
  "黑龙江": "黑龍江",
  "湖北": "湖北",
  "湖南": "湖南",
  "吉林": "吉林",
  "江苏": "江蘇",
  "江西": "江西",
  "辽宁": "遼寧",
  "内蒙古": "內蒙古",
  "宁夏": "寧夏",
  "青海": "青海",
  "山东": "山東",
  "山西": "山西",
  "陕西": "陝西",
  "上海": "上海",
  "四川": "四川",
  "天津": "天津",
  "西藏": "西藏",
  "新疆": "新疆",
  "云南": "雲南",
  "浙江": "浙江",
  "重庆": "重慶",
  "澳门": "澳門",
  "香港": "香港",
  "台湾": "臺灣",
  "南海诸岛": "南海諸島"
}
